//MAP CONVERTED BY dmm2tgm.py THIS HEADER COMMENT PREVENTS RECONVERSION, DO NOT REMOVE
"a" = (
/turf/open/space/basic,
/area/space)
"b" = (
/obj/structure/surface/table/reinforced/toc/east,
/turf/open/floor/almayer,
/area/space)
"d" = (
/turf/closed/wall/mineral/gold,
/area/space)
"e" = (
/obj/structure/surface/table/reinforced/almayer_B,
/obj/structure/surface/table/reinforced/almayer_blend,
/turf/open/floor/almayer,
/area/space)
"g" = (
/obj/structure/machinery/smartfridge,
/turf/open/floor/almayer,
/area/space)
"h" = (
/turf/closed/wall/strata_outpost/reinforced,
/area/space)
"j" = (
/turf/closed/wall/strata_outpost_ribbed,
/area/space)
"k" = (
/turf/open/floor/plating/prison,
/area/space)
"l" = (
/obj/structure/surface/table/reinforced/almayer_blend,
/turf/open/floor/almayer,
/area/space)
"n" = (
/turf/open/mars,
/area/space)
"p" = (
/obj/structure/surface/table/reinforced/almayer_B,
/turf/open/floor/almayer,
/area/space)
"r" = (
/obj/structure/machinery/door/airlock/multi_tile/elevator/access/dormatory,
/turf/open/shuttle/brig,
/area/space)
"w" = (
/turf/open/blank,
/area/space)
"y" = (
/turf/open/mars_cave,
/area/space)
"A" = (
/obj/structure/surface/table/reinforced/almayer_B,
/obj/structure/surface/table/reinforced/almayer_blend/north,
/turf/open/floor/almayer,
/area/space)
"B" = (
/turf/open/ice,
/area/space)
"C" = (
/turf/open/floor/almayer,
/area/space)
"E" = (
/turf/closed/wall/mineral,
/area/space)
"F" = (
/obj/structure/xenoautopsy/jar_shelf{
	pixel_y = 18
	},
/turf/open/floor/almayer,
/area/space)
"G" = (
/obj/structure/xenoautopsy{
	pixel_y = 18;
	desc = "A cabinet full of sealed, numbered jars with unknown substances in them.";
	name = "jar shelf"
	},
/turf/open/floor/almayer,
/area/space)
"I" = (
/turf/closed/wall/mineral/diamond,
/area/space)
"J" = (
/obj/docking_port/stationary/marine_dropship/lz1{
	name = "Hangar Landing Zone"
	},
/turf/open/floor/plating/prison,
/area/space)
"K" = (
/obj/structure/surface/table/reinforced/prison,
/turf/open/floor/almayer,
/area/space)
"L" = (
/turf/open/shuttle,
/area/space)
"Q" = (
/obj/structure/surface/table/reinforced/almayer_blend/north,
/turf/open/floor/almayer,
/area/space)
"T" = (
/obj/structure/surface/table/reinforced/toc/west,
/turf/open/floor/almayer,
/area/space)
"U" = (
/obj/structure/surface/table/reinforced/black,
/turf/open/floor/almayer,
/area/space)
"V" = (
/turf/open/shuttle/brig,
/area/space)
"Y" = (
/obj/structure/surface/table/reinforced/almayer_blend,
/obj/structure/surface/table/reinforced/almayer_B,
/turf/open/floor/almayer,
/area/space)

(1,1,1) = {"
a
a
a
a
a
a
a
a
a
a
a
a
a
a
a
a
a
a
a
a
a
a
a
a
a
a
a
a
a
a
a
a
a
a
a
a
a
a
a
a
a
a
a
a
a
a
a
a
a
a
a
a
a
a
a
a
a
a
a
a
a
a
a
a
a
a
a
a
a
a
a
a
a
a
a
a
a
a
a
a
w
w
w
w
w
w
a
w
w
w
w
w
w
a
w
w
w
w
w
w
"}
(2,1,1) = {"
a
a
a
a
a
a
a
a
a
a
a
a
a
a
a
a
a
a
a
a
a
a
a
a
a
a
a
a
a
a
a
a
a
a
a
a
a
a
a
a
a
a
a
a
a
a
a
a
a
a
a
a
a
a
a
a
a
a
a
a
a
a
a
a
a
a
a
a
a
a
a
a
a
a
a
a
a
a
a
a
w
w
w
w
w
w
a
w
w
w
w
w
w
a
w
w
w
w
w
w
"}
(3,1,1) = {"
a
a
a
a
a
a
a
a
a
a
a
a
a
a
a
a
a
a
a
a
a
a
a
a
a
a
a
a
a
a
a
a
a
a
a
a
a
a
a
a
a
a
a
a
a
a
a
a
a
a
a
a
a
a
a
a
a
a
a
a
a
a
a
a
a
a
a
a
a
a
a
a
a
a
a
a
a
a
a
a
w
w
w
w
w
w
a
w
w
w
w
w
w
a
w
w
w
w
w
w
"}
(4,1,1) = {"
a
a
a
a
a
a
a
a
a
a
a
a
a
a
a
a
a
a
a
a
a
a
a
a
a
a
a
a
a
a
a
a
a
a
a
a
a
a
a
a
a
a
a
a
a
a
a
a
a
a
a
a
a
a
a
a
a
a
a
a
a
a
a
a
a
a
a
a
a
a
a
a
a
a
a
a
a
a
a
a
w
w
w
w
w
w
a
w
w
w
w
w
w
a
w
w
w
w
w
w
"}
(5,1,1) = {"
a
a
a
a
a
a
a
a
a
a
a
a
a
a
a
a
a
a
a
a
a
a
a
a
a
a
a
a
a
a
a
a
a
a
a
a
a
a
a
a
a
a
a
a
a
a
a
a
a
a
a
a
a
a
a
a
a
a
a
a
a
a
a
a
a
a
a
a
a
a
a
a
a
a
a
a
a
a
a
a
a
a
a
a
a
a
a
a
a
a
a
a
a
a
a
a
a
a
a
a
"}
(6,1,1) = {"
a
y
y
y
y
y
y
a
a
a
a
a
a
a
a
a
a
a
a
a
a
a
a
a
a
a
a
a
a
a
a
a
a
a
a
a
a
a
a
a
a
a
a
a
a
a
a
a
a
a
a
a
a
a
a
a
a
a
a
a
a
a
a
a
a
a
a
a
a
a
a
a
a
a
a
a
a
a
a
a
a
a
a
a
a
a
a
a
a
a
a
a
a
a
a
a
a
a
a
a
"}
(7,1,1) = {"
y
y
a
a
a
a
a
y
y
a
a
a
a
a
a
a
a
a
a
a
a
a
a
a
a
a
a
a
a
a
a
a
a
a
a
a
a
a
a
a
a
a
a
a
a
a
a
a
a
a
a
a
a
a
a
a
a
a
a
a
a
a
a
a
a
a
a
a
a
a
a
a
a
a
a
a
a
a
a
a
a
a
a
a
a
a
a
a
a
a
a
a
a
a
a
a
a
a
a
a
"}
(8,1,1) = {"
a
a
a
a
a
a
a
a
y
a
a
a
a
a
a
a
a
a
a
a
a
a
a
a
a
a
a
a
a
a
a
a
a
a
a
a
a
a
a
a
a
a
a
a
a
a
a
a
a
a
a
a
a
a
a
a
a
a
a
a
a
a
a
a
a
a
a
a
a
a
a
a
a
a
a
a
a
a
a
a
a
a
a
a
a
a
a
a
a
a
a
a
a
a
a
a
a
a
a
a
"}
(9,1,1) = {"
a
a
a
a
a
a
a
a
a
y
a
a
a
a
a
a
a
a
a
a
a
a
a
a
a
a
a
a
a
a
a
a
a
a
a
a
a
a
a
a
a
a
a
a
a
a
a
a
a
a
a
a
a
a
a
a
a
a
a
a
a
a
a
a
a
a
a
a
a
a
a
a
a
a
a
a
a
a
a
a
a
a
a
a
a
a
a
a
a
a
g
C
p
e
A
Y
a
a
a
a
"}
(10,1,1) = {"
a
a
a
a
a
a
a
a
a
y
a
a
a
a
a
a
a
a
a
a
a
a
a
a
a
a
a
a
a
a
a
a
a
a
a
a
a
a
a
a
a
a
a
a
a
a
a
a
a
a
a
a
a
a
a
a
a
a
a
a
a
a
a
a
a
a
a
a
a
a
a
a
a
a
a
a
a
a
a
a
a
a
a
a
a
a
a
a
a
a
C
C
C
C
C
C
a
a
a
a
"}
(11,1,1) = {"
a
a
a
a
a
a
a
a
a
y
a
a
a
a
a
a
a
a
a
a
a
a
a
a
a
a
a
a
a
a
a
a
a
a
a
a
a
a
a
a
a
a
a
a
a
a
a
a
a
a
a
a
a
a
a
a
a
a
a
a
a
a
a
a
a
a
a
a
a
a
a
a
a
a
a
a
a
a
a
a
a
a
a
a
a
a
a
a
a
a
C
C
C
C
C
C
a
a
a
a
"}
(12,1,1) = {"
a
a
a
a
a
a
a
a
a
a
y
y
y
y
y
y
a
a
a
y
y
y
y
y
a
a
a
a
a
a
a
a
a
a
a
a
a
a
a
a
a
a
a
a
a
a
a
a
a
a
a
a
a
a
a
a
a
a
a
a
a
a
a
a
a
a
a
a
a
a
a
a
a
a
a
a
a
a
a
a
a
a
a
a
a
a
a
a
a
a
C
C
p
e
A
Y
a
a
a
a
"}
(13,1,1) = {"
a
a
a
a
a
a
a
a
a
a
a
a
a
a
a
y
y
y
y
y
a
a
a
y
y
a
a
a
a
a
a
a
a
a
a
a
a
a
a
a
a
a
a
a
a
a
a
a
a
a
a
a
a
a
a
a
a
a
a
a
a
a
a
a
a
a
a
a
a
a
a
a
a
a
a
a
a
a
a
a
a
a
a
a
a
a
a
a
a
a
C
C
C
C
C
C
a
a
a
a
"}
(14,1,1) = {"
a
a
a
a
a
a
a
a
a
a
a
a
a
a
a
a
a
a
a
a
a
a
a
a
y
y
a
a
a
a
a
a
a
a
a
a
a
a
a
a
a
a
a
a
a
a
a
a
a
a
a
a
a
a
a
a
a
a
a
a
a
a
a
a
a
a
a
a
a
a
a
a
a
a
a
a
a
a
a
a
a
a
a
a
a
a
a
a
a
a
G
C
C
C
C
C
a
a
a
a
"}
(15,1,1) = {"
a
a
a
a
a
a
a
a
a
a
a
a
a
a
a
a
a
a
a
a
a
a
a
a
a
y
y
y
a
a
a
a
a
a
a
a
a
a
a
a
a
a
a
a
a
a
a
a
a
a
a
a
a
a
a
a
a
a
a
a
a
a
a
a
a
a
a
a
a
a
a
a
a
a
a
a
a
a
a
a
a
a
a
a
a
a
a
a
a
a
F
C
p
e
A
Y
a
a
a
a
"}
(16,1,1) = {"
a
a
a
a
a
a
a
a
a
a
a
a
a
a
a
a
a
a
a
a
a
a
a
a
a
a
a
y
y
a
a
a
a
a
a
a
a
a
a
a
a
a
a
a
a
a
a
a
a
a
a
a
a
a
a
a
a
a
a
a
y
y
y
a
a
a
a
a
a
a
a
a
a
a
a
a
a
a
a
a
a
a
a
a
a
a
a
a
a
a
G
C
C
C
C
C
a
a
a
a
"}
(17,1,1) = {"
a
a
a
a
a
a
a
a
a
a
a
a
a
a
a
a
a
a
a
a
a
a
a
a
a
a
a
a
y
y
a
a
a
a
a
a
a
a
a
a
a
a
a
a
a
a
a
a
a
a
a
a
a
a
a
a
a
a
a
y
y
a
y
y
y
y
y
a
a
a
a
a
a
a
a
a
a
a
a
a
a
a
a
a
a
a
a
a
a
a
g
C
C
C
C
C
a
a
a
a
"}
(18,1,1) = {"
a
a
a
a
a
a
a
a
a
a
a
a
a
a
a
a
a
a
a
a
a
a
a
a
a
a
a
a
a
a
y
y
y
y
y
y
a
a
a
a
a
a
a
a
a
a
a
a
a
a
y
y
y
y
y
y
y
y
y
y
a
a
a
a
a
a
y
y
y
y
y
y
y
a
a
a
a
a
a
a
a
a
a
a
a
a
a
a
a
a
C
C
p
e
A
Y
a
a
a
a
"}
(19,1,1) = {"
a
a
a
a
a
a
a
a
a
a
a
a
a
a
a
a
a
a
a
a
a
a
a
a
a
a
a
a
a
a
a
a
a
a
a
y
y
a
a
a
a
a
a
a
a
a
a
a
a
y
y
a
a
a
a
a
a
a
a
a
a
a
a
a
a
a
a
a
y
y
a
a
y
y
a
a
a
a
a
a
a
a
a
a
a
a
a
a
a
a
a
a
a
a
a
a
a
a
a
a
"}
(20,1,1) = {"
a
a
a
a
a
a
a
a
a
a
a
a
a
a
a
a
a
a
a
a
a
a
a
a
a
a
a
a
a
a
a
a
a
a
a
a
a
y
y
y
y
y
y
y
y
y
y
y
y
a
a
a
a
a
a
a
a
a
a
a
a
a
a
a
a
a
a
a
a
a
a
a
a
y
a
a
a
a
a
a
a
a
a
a
a
a
a
a
a
a
a
a
a
a
a
a
a
a
a
a
"}
(21,1,1) = {"
L
L
L
L
L
L
L
L
a
a
a
a
a
a
a
a
a
a
a
a
a
a
a
a
a
a
a
a
a
a
a
a
a
a
a
a
a
a
a
y
a
a
a
a
a
a
a
a
a
a
a
a
a
a
a
a
a
a
a
a
a
a
a
a
a
a
a
a
a
a
a
a
a
a
a
a
a
a
a
a
a
a
a
a
a
a
a
a
a
C
C
C
C
C
C
C
C
C
C
a
"}
(22,1,1) = {"
L
L
L
L
L
L
L
L
L
L
a
a
a
a
a
a
a
a
a
a
a
a
a
a
a
a
a
a
a
a
a
a
a
a
a
a
a
a
a
a
a
a
a
a
a
a
a
a
a
a
a
a
a
a
a
a
a
a
a
a
a
a
a
a
a
a
a
a
a
a
a
a
a
a
a
a
a
a
a
a
a
a
a
a
a
a
a
a
a
C
C
C
C
C
C
C
C
C
C
a
"}
(23,1,1) = {"
L
L
L
L
L
L
L
L
L
L
L
a
a
a
a
a
a
a
a
a
a
a
a
a
a
a
a
a
a
a
a
a
a
a
a
a
a
a
a
a
a
a
a
a
a
a
a
a
a
a
a
a
a
a
a
a
a
a
a
a
a
a
a
a
a
a
a
a
a
a
a
a
a
a
a
a
a
a
a
a
a
a
a
a
a
a
a
a
a
C
C
C
C
K
K
K
K
C
C
a
"}
(24,1,1) = {"
L
L
L
L
L
L
L
L
L
L
L
L
a
a
a
a
a
a
a
a
a
a
a
a
a
a
a
a
a
a
a
a
a
a
a
a
a
a
a
a
a
a
a
a
a
a
a
a
a
a
a
a
a
a
a
a
a
a
a
a
a
a
a
a
a
a
a
a
a
a
a
a
a
a
a
a
a
a
a
a
a
a
a
a
a
a
a
a
a
C
C
C
C
C
C
C
C
C
C
a
"}
(25,1,1) = {"
L
L
L
L
L
L
L
L
L
L
L
L
L
a
a
a
a
a
a
a
a
a
a
a
a
a
a
a
a
a
a
a
a
a
a
a
a
a
a
a
a
a
a
a
a
a
a
a
a
a
a
a
a
a
a
a
a
a
a
a
a
a
a
a
a
a
a
a
a
a
a
a
a
a
a
a
a
a
a
a
a
a
a
a
a
a
j
a
a
C
C
C
C
C
C
C
C
C
C
a
"}
(26,1,1) = {"
L
L
L
L
L
L
L
L
L
L
L
L
L
L
a
a
a
a
a
a
a
a
a
a
a
a
a
a
a
a
a
a
a
a
a
a
a
a
a
a
a
a
a
a
a
a
a
a
a
a
a
a
a
a
a
a
a
a
a
a
a
a
a
a
a
a
a
a
a
a
a
a
a
a
a
a
a
a
a
a
a
a
a
a
a
a
h
a
a
C
C
T
C
K
K
K
K
C
C
a
"}
(27,1,1) = {"
a
a
a
a
L
L
L
L
L
L
L
L
L
L
L
d
a
a
a
a
a
a
a
a
a
a
a
a
a
a
a
a
a
a
a
a
a
a
a
a
a
a
a
a
a
a
a
a
a
a
a
a
a
a
a
a
a
a
a
a
a
a
a
a
a
a
a
a
a
a
a
a
a
a
a
a
a
a
a
a
a
a
a
a
a
a
h
a
a
C
C
b
C
U
Q
p
l
C
C
a
"}
(28,1,1) = {"
a
a
a
a
a
L
L
L
L
L
L
L
L
L
L
d
a
a
a
a
a
a
a
a
a
a
a
a
a
a
a
a
a
w
w
w
w
w
w
w
w
w
w
w
w
w
w
w
w
w
w
w
w
w
w
w
w
w
w
w
a
a
a
a
a
a
a
a
a
a
a
a
a
a
a
a
a
a
a
a
a
a
a
a
a
a
a
a
a
C
C
C
C
C
C
C
C
C
C
a
"}
(29,1,1) = {"
a
a
a
a
a
a
L
L
L
L
L
L
L
L
L
d
a
a
a
a
a
a
a
a
a
a
a
a
a
a
a
w
w
w
w
w
w
w
w
w
w
w
w
w
w
w
w
w
w
w
w
w
w
w
w
w
w
w
w
w
w
w
a
a
a
a
a
a
a
a
a
a
a
a
a
a
a
a
a
a
a
a
a
a
a
a
a
a
a
a
a
a
a
a
a
a
a
a
a
a
"}
(30,1,1) = {"
a
a
a
a
a
a
a
L
L
L
L
L
L
L
L
d
a
a
a
a
a
a
a
a
a
a
a
a
w
w
w
w
w
w
w
w
w
w
w
w
w
w
w
w
w
w
w
w
w
w
w
w
w
w
w
w
w
w
w
w
w
w
w
w
w
w
a
a
a
a
a
a
a
a
a
a
a
a
a
a
a
a
a
a
a
a
a
a
a
a
a
a
a
a
a
a
a
a
a
a
"}
(31,1,1) = {"
a
a
a
a
a
a
a
a
L
L
L
L
L
L
L
d
a
a
a
a
a
a
a
a
a
a
a
a
w
w
w
w
w
w
w
w
w
w
w
w
w
w
w
w
w
w
w
w
w
w
w
w
w
w
w
w
w
w
w
w
w
w
w
w
w
w
a
a
a
a
a
a
a
a
a
a
a
a
a
a
a
a
a
a
a
a
a
a
a
a
a
a
a
a
a
a
a
a
a
a
"}
(32,1,1) = {"
a
a
a
a
d
d
d
d
d
L
L
L
L
L
L
d
a
a
a
a
a
a
a
a
a
a
a
a
w
w
w
w
w
w
w
w
w
w
w
w
w
w
w
w
w
w
w
w
w
w
w
w
w
w
w
w
w
w
w
w
w
w
w
w
w
w
a
a
a
a
a
a
a
a
a
a
a
a
a
a
a
a
a
a
a
a
a
a
a
a
a
a
a
a
a
a
a
a
a
a
"}
(33,1,1) = {"
a
a
a
a
d
a
a
a
d
L
L
L
L
L
L
d
a
a
a
a
a
a
a
a
a
a
a
a
w
w
w
w
w
w
a
a
a
a
a
a
a
a
B
B
B
B
B
a
a
a
a
a
a
a
a
a
a
a
a
w
w
w
w
w
w
w
a
a
a
a
a
a
a
a
a
a
a
a
a
a
a
a
a
a
a
a
a
a
a
a
a
a
a
a
a
a
a
a
a
a
"}
(34,1,1) = {"
a
a
a
a
d
a
a
a
d
L
L
L
L
L
L
d
a
a
a
a
a
a
a
a
a
a
w
w
w
w
w
w
a
a
a
a
a
a
a
a
a
a
B
B
B
B
B
a
a
a
a
a
a
a
a
a
a
a
a
a
a
a
w
w
w
w
w
w
a
a
a
a
a
a
a
a
a
a
a
a
a
a
a
a
a
a
a
a
a
a
a
a
a
a
a
a
a
a
a
a
"}
(35,1,1) = {"
a
a
a
a
d
a
a
a
d
L
L
L
L
L
L
d
a
a
a
a
a
a
a
a
a
a
w
w
w
w
w
w
a
a
a
a
a
a
a
a
a
a
B
B
B
B
B
a
a
a
a
a
a
a
a
a
a
a
a
a
a
a
w
w
w
w
w
w
a
a
a
a
a
a
a
a
a
a
a
a
a
a
a
a
a
a
a
a
a
a
a
a
a
a
a
a
a
a
a
a
"}
(36,1,1) = {"
a
a
a
a
d
a
a
a
d
L
L
L
L
L
L
d
a
a
a
a
a
a
a
a
a
a
w
w
w
w
w
w
a
a
a
a
a
a
a
a
a
a
B
B
B
B
B
a
a
a
a
a
a
a
a
a
a
a
a
a
a
a
w
w
w
w
w
w
a
a
a
a
a
a
a
a
a
a
a
a
a
a
a
a
a
a
a
a
a
a
a
a
a
a
a
a
a
a
a
a
"}
(37,1,1) = {"
a
a
a
a
d
a
a
a
d
L
L
L
L
L
L
d
a
a
a
a
a
a
a
a
w
w
w
w
w
w
w
w
a
a
a
a
a
a
a
a
a
a
B
B
B
B
B
a
a
a
a
a
a
a
a
a
a
a
a
a
a
a
w
w
w
w
w
w
a
a
a
a
a
a
a
a
a
a
a
a
a
a
a
a
a
a
a
a
a
a
a
a
a
a
a
a
a
a
a
a
"}
(38,1,1) = {"
a
a
a
a
d
a
a
a
d
L
L
L
L
L
L
d
a
a
a
a
a
a
a
a
w
w
w
w
w
w
a
a
a
a
a
a
a
a
a
a
a
a
B
B
B
B
B
a
a
a
a
a
a
a
a
a
a
a
a
a
a
a
a
a
w
w
w
w
w
w
a
a
a
a
a
a
a
a
a
a
a
a
a
a
a
a
a
a
a
a
a
a
a
a
a
a
a
a
a
a
"}
(39,1,1) = {"
a
a
a
a
d
d
d
d
d
L
L
L
L
L
L
d
a
a
a
a
a
a
a
a
w
w
w
w
w
w
a
a
a
a
a
a
a
a
a
a
a
a
B
B
B
B
B
a
a
a
a
a
a
a
a
a
a
a
a
a
a
a
a
a
w
w
w
w
w
w
a
a
a
a
a
a
a
a
a
a
a
a
a
a
a
a
a
a
a
a
a
a
a
a
a
a
a
a
a
a
"}
(40,1,1) = {"
a
a
a
a
a
a
a
a
d
L
L
L
L
L
L
d
a
a
a
a
a
a
w
w
w
w
w
w
w
w
a
a
a
a
a
a
a
a
a
a
a
a
B
B
B
B
B
a
a
a
a
a
a
a
a
a
a
a
a
a
a
a
a
a
w
w
w
w
w
w
w
a
a
a
a
a
a
a
a
a
a
a
a
a
a
a
a
a
a
a
a
a
a
a
a
a
a
a
a
a
"}
(41,1,1) = {"
a
a
a
a
a
a
a
a
d
L
L
L
L
L
L
d
a
a
a
a
a
a
w
w
w
w
w
w
a
a
a
a
a
a
a
a
a
a
a
a
a
a
B
B
B
B
B
a
a
a
a
a
a
a
a
a
a
a
a
a
a
a
a
a
w
w
w
w
w
w
w
a
a
a
a
a
a
a
a
a
a
a
a
a
a
a
a
a
a
a
a
a
a
a
a
a
a
a
a
a
"}
(42,1,1) = {"
a
a
a
a
a
a
a
a
d
L
L
L
L
L
L
d
a
a
a
a
a
a
w
w
w
w
w
w
a
a
a
a
a
a
a
a
a
a
a
a
a
a
B
B
B
B
B
a
a
a
a
a
a
a
a
a
a
a
a
a
a
a
a
a
a
a
w
w
w
w
w
a
a
a
a
a
a
a
a
a
a
a
a
a
a
a
a
a
a
a
a
a
a
a
a
a
a
a
a
a
"}
(43,1,1) = {"
a
a
a
a
a
a
a
a
d
L
L
L
L
L
L
d
a
a
a
a
w
w
w
w
w
w
w
w
a
a
a
a
a
a
a
a
a
a
a
a
a
a
B
B
B
B
B
a
a
a
a
a
a
a
a
a
a
a
a
a
a
a
a
a
a
a
w
w
w
w
w
a
a
a
a
a
a
a
a
a
a
a
a
a
a
a
a
a
a
a
a
a
a
a
a
a
a
a
a
a
"}
(44,1,1) = {"
a
a
a
a
a
a
a
a
d
L
L
L
L
L
L
d
a
a
a
a
w
w
w
w
w
w
a
a
a
a
a
a
a
a
a
a
a
a
a
a
a
a
B
B
B
B
B
a
a
a
a
a
a
a
a
a
a
a
a
a
a
a
a
a
a
a
a
w
w
w
w
a
a
a
a
a
a
a
a
a
a
a
a
a
a
a
a
a
a
a
a
a
a
a
a
a
a
a
a
a
"}
(45,1,1) = {"
a
a
a
a
a
a
a
a
d
L
L
L
L
L
L
d
a
a
a
a
w
w
w
w
w
w
a
a
a
a
a
a
a
a
a
a
a
a
a
a
a
a
B
B
B
B
B
a
a
a
a
a
a
a
a
a
a
a
a
a
a
a
a
a
a
a
a
w
w
w
w
a
a
a
a
a
a
a
a
a
a
a
a
a
a
a
a
a
a
a
a
a
a
a
a
a
a
a
a
a
"}
(46,1,1) = {"
a
a
a
a
a
a
a
a
d
L
L
L
L
L
L
d
a
a
a
a
w
w
w
w
w
w
a
a
a
a
a
a
a
a
a
a
a
a
a
a
a
a
B
B
B
B
B
a
a
a
a
a
a
a
a
a
a
a
a
a
a
a
a
a
a
a
a
w
w
w
w
w
a
a
a
a
a
a
a
a
a
a
a
a
a
a
a
a
a
a
a
a
a
a
a
a
a
a
a
a
"}
(47,1,1) = {"
a
a
a
a
a
a
a
a
d
L
L
L
L
L
L
d
a
a
a
a
w
w
w
w
w
w
a
a
a
a
a
a
a
a
a
a
a
a
a
a
a
a
B
B
B
B
B
a
a
a
a
a
a
a
a
a
a
a
a
a
a
a
a
a
a
a
a
w
w
w
w
w
a
a
a
a
a
a
a
a
a
a
a
a
a
a
a
a
a
a
a
a
a
a
a
a
a
a
a
a
"}
(48,1,1) = {"
a
a
a
a
a
a
a
a
d
L
L
L
L
L
L
d
a
a
a
a
w
w
w
w
w
w
a
a
a
a
a
a
a
a
a
a
a
a
a
a
a
a
B
B
B
B
B
a
a
a
a
a
a
a
a
a
a
a
a
a
a
a
a
a
a
a
a
a
w
w
w
w
a
a
a
a
a
a
a
a
a
a
a
a
a
a
a
a
a
a
a
a
a
a
a
a
a
a
a
a
"}
(49,1,1) = {"
a
a
a
a
a
a
a
a
d
L
L
L
L
L
L
d
a
a
a
a
w
w
w
w
w
w
a
a
a
a
a
a
a
a
a
a
a
a
a
a
a
a
B
B
B
B
B
a
a
a
a
a
a
a
a
a
a
a
a
a
a
a
a
a
a
a
a
a
w
w
w
w
a
a
a
a
a
a
a
a
a
a
a
a
a
a
a
a
a
a
a
a
a
a
a
a
a
a
a
a
"}
(50,1,1) = {"
a
a
a
a
a
a
a
a
d
L
L
L
L
L
L
d
a
a
a
a
w
w
w
w
w
w
a
a
a
a
a
a
a
a
a
a
a
a
a
a
a
a
B
B
B
B
B
a
a
a
a
a
a
a
a
a
a
a
a
a
a
a
a
a
a
a
a
a
w
w
w
w
a
a
a
a
a
a
a
a
a
a
a
a
a
a
a
a
a
a
a
a
a
a
a
a
a
a
a
a
"}
(51,1,1) = {"
a
a
a
a
a
a
a
a
d
L
L
L
L
L
L
d
a
a
a
a
w
w
w
w
w
w
a
a
a
a
a
a
a
a
a
a
a
a
a
a
a
a
B
B
B
B
B
a
a
a
a
a
a
a
a
a
a
a
a
a
a
a
a
a
a
a
a
a
w
w
w
w
a
a
a
a
a
a
a
a
a
a
a
a
a
a
a
a
a
a
a
a
a
a
a
a
a
a
a
a
"}
(52,1,1) = {"
a
a
a
a
a
a
a
a
d
L
L
L
L
L
L
d
a
a
a
a
w
w
w
w
w
w
a
a
a
a
a
a
a
a
a
a
a
a
a
a
a
a
B
B
B
B
B
a
a
a
a
a
a
a
a
a
a
a
a
a
a
a
a
a
a
a
a
a
w
w
w
w
a
a
a
a
a
a
a
a
a
a
a
a
a
a
a
a
a
a
a
a
a
a
a
a
a
a
a
a
"}
(53,1,1) = {"
a
a
a
a
a
a
a
a
d
L
L
L
L
L
L
d
a
a
a
a
w
w
w
w
w
w
a
a
a
a
a
a
a
a
a
a
a
a
a
a
a
a
B
B
B
B
B
a
a
a
a
a
a
a
a
a
a
a
a
a
a
a
a
a
a
a
a
a
w
w
w
w
a
a
a
a
a
a
a
a
a
a
a
a
a
a
a
a
a
a
a
a
a
a
a
a
a
a
a
a
"}
(54,1,1) = {"
a
a
a
a
a
a
a
a
d
L
L
L
L
L
L
d
a
a
a
a
w
w
w
w
w
w
a
a
a
a
a
a
a
a
a
a
k
k
k
k
k
k
k
k
k
k
k
k
k
k
k
a
a
a
a
a
a
a
a
a
a
a
a
a
a
a
a
a
w
w
w
w
a
a
a
a
a
a
a
a
a
a
a
a
a
a
a
a
a
a
a
a
a
a
a
a
a
a
a
a
"}
(55,1,1) = {"
a
a
a
a
a
a
a
a
d
L
L
L
L
L
L
d
a
a
a
a
w
w
w
w
w
w
a
a
a
a
a
a
a
a
a
a
k
k
k
k
k
k
k
k
k
k
k
k
k
k
k
a
a
a
a
a
a
a
a
a
a
a
a
a
a
a
a
a
w
w
w
w
a
a
a
a
a
a
a
a
a
a
a
a
a
a
a
a
a
a
a
a
a
a
a
a
a
a
a
a
"}
(56,1,1) = {"
a
a
a
a
a
a
a
a
d
L
L
L
L
L
L
d
a
a
a
a
w
w
w
w
w
w
a
a
a
a
a
a
a
a
a
a
k
k
k
k
k
k
k
k
k
k
k
k
k
k
k
a
a
a
a
a
a
a
a
a
a
a
a
a
a
a
a
a
w
w
w
w
a
a
a
a
a
a
a
a
a
a
a
a
a
a
a
a
a
a
a
a
a
a
a
a
a
a
a
a
"}
(57,1,1) = {"
a
a
a
a
a
a
a
a
d
L
L
L
L
L
L
d
a
a
a
a
w
w
w
w
w
w
a
a
a
a
a
a
a
a
a
a
k
k
k
k
k
k
k
k
k
k
k
k
k
k
k
a
a
a
a
a
a
a
a
a
a
a
a
a
a
a
a
a
w
w
w
w
a
a
a
a
a
a
a
a
a
a
a
a
a
a
a
a
a
a
a
a
a
a
a
a
a
a
a
a
"}
(58,1,1) = {"
a
a
a
a
a
a
a
a
d
L
L
L
L
L
L
d
a
a
a
a
w
w
w
w
w
w
a
a
a
a
a
a
a
a
a
a
k
k
k
k
k
k
k
J
k
k
k
k
k
k
k
a
a
a
a
a
a
a
a
a
a
a
a
a
a
a
a
a
w
w
w
w
a
a
a
a
a
a
a
a
a
a
a
a
a
a
a
a
a
a
a
a
a
a
a
a
a
a
a
a
"}
(59,1,1) = {"
a
a
w
w
w
w
w
a
d
L
L
L
L
L
L
d
a
a
a
a
w
w
w
w
w
w
a
a
a
a
a
a
a
a
a
a
k
k
k
k
k
k
k
k
k
k
k
k
k
k
k
a
a
a
a
a
a
a
a
a
a
a
a
a
a
a
a
a
w
w
w
w
a
a
a
a
a
a
a
a
a
a
a
a
a
a
a
a
a
a
a
a
a
a
a
a
a
a
a
a
"}
(60,1,1) = {"
a
a
w
w
w
w
w
a
d
L
L
L
L
L
L
d
a
a
a
a
w
w
w
w
w
w
a
a
a
a
a
a
a
a
a
a
k
k
k
k
k
k
k
k
k
k
k
k
k
k
k
a
a
a
a
a
a
a
a
a
a
a
a
a
a
a
a
a
w
w
w
w
a
a
a
a
a
a
a
a
a
a
a
a
a
a
a
a
a
a
a
a
a
a
a
a
a
a
a
a
"}
(61,1,1) = {"
a
w
w
w
w
w
w
w
d
L
L
L
L
L
L
d
a
a
a
a
w
w
w
w
w
w
a
a
a
a
a
a
a
a
a
a
k
k
k
k
k
k
k
k
k
k
k
k
k
k
k
a
a
a
a
a
a
a
a
a
a
a
a
a
a
a
a
a
w
w
w
w
a
a
a
a
a
a
a
a
a
a
a
a
a
a
a
a
a
a
a
a
a
a
a
a
a
a
a
a
"}
(62,1,1) = {"
a
w
w
w
w
w
w
w
d
L
L
L
L
L
L
d
a
a
a
a
w
w
w
w
w
w
a
a
a
a
a
a
a
a
a
a
k
k
k
k
k
k
k
k
k
k
k
k
k
k
k
a
a
a
a
a
a
a
a
a
a
a
a
a
a
a
a
a
w
w
w
w
a
a
a
a
a
a
a
a
a
a
a
a
a
a
a
a
a
a
a
a
a
a
a
a
a
a
a
a
"}
(63,1,1) = {"
a
w
w
w
w
w
w
w
d
L
L
L
L
L
L
d
a
a
a
a
w
w
w
w
w
w
a
a
a
a
a
a
a
a
a
a
a
a
a
a
a
a
B
B
B
B
B
a
a
a
a
a
a
a
a
a
a
a
a
a
a
a
a
a
a
a
a
a
w
w
w
w
a
a
a
a
a
a
a
a
a
a
a
a
a
a
a
a
a
a
a
a
a
a
a
a
a
a
a
a
"}
(64,1,1) = {"
a
w
w
w
w
w
w
w
L
L
L
L
L
L
L
d
a
a
a
a
w
w
w
w
w
w
a
a
a
a
a
a
a
a
a
a
a
a
a
a
a
a
B
B
B
B
B
a
a
a
a
a
a
a
a
a
a
a
a
a
a
a
a
a
a
a
a
a
w
w
w
w
a
a
a
a
a
a
a
a
a
a
a
a
a
a
a
a
a
a
a
a
a
a
a
a
a
a
a
a
"}
(65,1,1) = {"
a
w
w
w
w
w
w
w
L
L
L
L
L
L
L
d
a
a
a
a
w
w
w
w
w
w
a
a
a
a
a
a
a
a
a
a
a
a
a
a
a
a
B
B
B
B
B
a
a
a
a
a
a
a
a
a
a
a
a
a
a
a
a
a
a
a
a
a
w
w
w
w
a
a
a
a
a
a
a
a
a
a
a
a
a
a
a
a
a
a
a
a
a
a
a
a
a
a
a
a
"}
(66,1,1) = {"
a
w
w
w
w
w
w
w
L
L
L
L
L
L
L
d
a
a
a
a
w
w
w
w
w
w
a
a
a
a
a
a
a
a
a
a
a
a
a
a
a
a
B
B
B
B
B
a
a
a
a
a
a
a
a
a
a
a
a
a
a
a
a
a
a
a
a
a
w
w
w
w
a
a
a
a
a
a
a
a
a
a
a
a
a
a
a
a
a
a
a
a
a
a
a
a
a
a
a
a
"}
(67,1,1) = {"
a
w
w
w
w
w
w
w
L
L
L
L
L
L
L
d
a
a
a
a
w
w
w
w
w
w
a
a
a
a
a
a
a
a
a
a
a
a
a
a
a
a
B
B
B
B
B
a
a
a
a
a
a
a
a
a
a
a
a
a
a
a
a
a
a
a
a
a
w
w
w
w
a
a
a
a
a
a
a
a
a
a
a
a
a
a
a
a
a
a
a
a
a
a
a
a
a
a
a
a
"}
(68,1,1) = {"
a
w
w
w
w
w
w
w
d
L
L
L
L
L
L
d
a
a
a
a
w
w
w
w
w
w
a
a
a
a
a
a
a
a
a
a
a
a
a
a
a
a
B
B
B
B
B
a
a
a
a
a
a
a
a
a
a
a
a
a
a
a
a
a
a
a
a
a
w
w
w
w
a
a
a
a
a
a
a
a
a
a
a
a
a
a
a
a
a
a
a
a
a
a
a
a
a
a
a
a
"}
(69,1,1) = {"
a
w
w
w
w
w
w
w
d
L
L
L
L
L
L
d
a
a
a
a
w
w
w
w
w
w
a
a
a
a
a
a
a
a
a
a
a
a
a
a
a
a
B
B
B
B
B
a
a
a
a
a
a
a
a
a
a
a
a
a
a
a
a
a
a
a
a
a
w
w
w
w
a
a
a
a
a
a
a
a
a
a
a
a
a
a
a
a
a
a
a
a
a
a
a
a
a
a
a
a
"}
(70,1,1) = {"
a
a
w
w
w
w
w
a
d
L
L
L
L
L
L
d
a
a
a
a
w
w
w
w
w
w
a
a
a
a
a
a
a
a
a
a
a
a
a
a
a
a
B
B
B
B
B
a
a
a
a
a
a
a
a
a
a
a
a
a
a
a
a
a
a
a
a
a
w
w
w
w
a
a
a
a
a
a
a
a
a
a
a
a
a
a
a
a
a
a
a
a
a
a
a
a
a
a
a
a
"}
(71,1,1) = {"
a
a
w
w
w
w
w
a
d
L
L
L
L
L
L
d
a
a
a
a
w
w
w
w
w
w
a
a
a
a
a
a
a
a
a
a
a
a
a
a
a
a
B
B
B
B
B
a
a
a
a
a
a
a
a
a
a
a
a
a
a
a
a
a
a
a
a
a
w
w
w
w
a
a
a
a
a
a
a
a
a
a
a
a
a
a
a
a
a
a
a
a
a
a
a
a
a
a
a
a
"}
(72,1,1) = {"
a
a
a
a
a
a
a
a
d
L
L
L
L
L
L
d
a
a
a
a
w
w
w
w
w
w
a
a
a
a
a
a
a
a
a
a
a
a
a
a
a
a
B
B
B
B
B
a
a
a
a
a
a
a
a
a
a
a
a
a
a
a
a
a
a
a
a
w
w
w
w
w
a
a
a
a
a
a
a
a
a
a
a
a
a
a
a
a
a
a
a
a
a
a
a
a
a
a
a
a
"}
(73,1,1) = {"
a
a
a
a
a
a
a
a
d
L
L
L
L
L
L
d
a
a
a
a
w
w
w
w
w
w
a
a
a
a
a
a
a
a
a
a
a
a
a
a
a
a
B
B
B
B
B
a
a
a
a
a
a
a
a
a
a
a
a
a
a
a
a
a
a
a
a
w
w
w
w
w
a
a
a
a
a
a
a
a
a
a
a
a
a
a
a
a
a
a
a
a
a
a
a
a
a
a
a
a
"}
(74,1,1) = {"
a
a
a
a
a
a
a
a
d
L
L
L
L
L
L
d
a
a
a
a
w
w
w
w
w
w
a
a
a
a
a
a
a
a
a
a
a
a
a
a
a
a
B
B
B
B
B
a
a
a
a
a
a
a
a
a
a
a
a
a
a
a
a
a
a
a
a
w
w
w
w
a
a
a
a
a
a
a
a
a
a
a
a
a
a
a
a
a
a
a
a
a
a
a
a
a
a
a
a
a
"}
(75,1,1) = {"
a
a
a
a
a
a
a
a
d
L
L
L
L
L
L
d
a
a
a
a
w
w
w
w
w
w
w
w
a
a
a
a
a
a
a
a
a
a
a
a
a
a
B
B
B
B
B
a
a
a
a
a
a
a
a
a
a
a
a
a
a
a
a
a
a
a
a
w
w
w
w
a
a
a
a
a
a
a
a
a
a
a
a
a
a
a
a
a
a
a
a
a
a
a
a
a
a
a
a
a
"}
(76,1,1) = {"
a
a
a
a
a
a
a
a
d
L
L
L
L
L
L
d
a
a
a
a
w
w
w
w
w
w
w
w
a
a
a
a
a
a
a
a
a
a
a
a
a
a
B
B
B
B
B
a
a
a
a
a
a
a
a
a
a
a
a
a
a
a
a
a
a
a
w
w
w
w
w
a
a
a
a
a
a
a
a
a
a
a
a
a
a
a
a
a
a
a
a
a
a
a
a
a
a
a
a
a
"}
(77,1,1) = {"
a
a
a
a
a
a
a
a
d
L
L
L
L
L
L
d
a
a
a
a
a
a
w
w
w
w
w
w
a
a
a
a
a
a
a
a
a
a
a
a
a
a
B
B
B
B
B
a
a
a
a
a
a
a
a
a
a
a
a
a
a
a
a
a
a
a
w
w
w
w
w
a
a
a
a
a
a
a
a
a
a
a
a
a
a
a
a
a
a
a
a
a
a
a
a
a
a
a
a
a
"}
(78,1,1) = {"
a
a
a
a
a
a
a
a
d
L
L
L
L
L
L
d
a
a
a
a
a
a
w
w
w
w
w
w
w
w
a
a
a
a
a
a
a
a
a
a
a
a
B
B
B
B
B
a
a
a
a
a
a
a
a
a
a
a
a
a
a
a
a
a
w
w
w
w
w
w
w
a
a
a
a
a
a
a
a
a
a
a
a
a
a
a
a
a
a
a
a
a
a
a
a
a
a
a
a
a
"}
(79,1,1) = {"
a
a
a
a
a
a
a
a
d
L
L
L
L
L
L
d
a
a
a
a
a
a
w
w
w
w
w
w
w
w
a
a
a
a
a
a
a
a
a
a
a
a
B
B
B
B
B
a
a
a
a
a
a
a
a
a
a
a
a
a
a
a
a
a
w
w
w
w
w
w
w
a
a
a
a
a
a
a
a
a
a
a
a
a
a
a
a
a
a
a
a
a
a
a
a
a
a
a
a
a
"}
(80,1,1) = {"
a
a
a
a
a
a
a
a
d
L
L
L
L
L
L
d
a
a
a
a
a
a
a
a
w
w
w
w
w
w
a
a
a
a
a
a
a
a
a
a
a
a
B
B
B
B
B
a
a
a
a
a
a
a
a
a
a
a
a
a
a
a
a
a
w
w
w
w
w
w
a
a
a
a
a
a
a
a
a
a
a
a
a
a
a
a
a
a
a
a
a
a
a
a
a
a
a
a
a
a
"}
(81,1,1) = {"
a
a
a
a
a
a
a
a
d
L
L
L
L
L
L
d
a
a
a
a
a
a
a
a
w
w
w
w
w
w
a
a
a
a
a
a
a
a
a
a
a
a
B
B
B
B
B
a
a
a
a
a
a
a
a
a
a
a
a
a
a
a
a
a
w
w
w
w
w
w
a
a
a
a
a
a
a
a
a
a
a
a
a
a
a
a
a
a
a
a
a
a
a
a
a
a
a
a
a
a
"}
(82,1,1) = {"
a
a
a
a
a
a
a
a
d
L
L
L
L
L
L
d
a
a
a
a
a
a
a
a
w
w
w
w
w
w
w
w
a
a
a
a
a
a
a
a
a
a
B
B
B
B
B
a
a
a
a
a
a
a
a
a
a
a
a
a
a
a
w
w
w
w
w
w
a
a
a
a
a
a
a
a
a
a
a
a
a
a
a
a
a
a
a
a
a
a
a
a
a
a
a
a
a
a
a
a
"}
(83,1,1) = {"
a
a
a
a
a
a
a
a
d
L
L
L
L
L
L
d
a
a
a
a
a
a
a
a
a
a
w
w
w
w
w
w
a
a
a
a
a
a
a
a
a
a
B
B
B
B
B
a
a
a
a
a
a
a
a
a
a
a
a
a
a
a
w
w
w
w
w
w
a
a
a
a
a
a
a
a
a
a
a
a
a
a
a
a
a
a
a
a
a
a
a
a
a
a
a
a
a
a
a
a
"}
(84,1,1) = {"
a
a
a
a
a
a
a
a
d
L
L
L
L
L
L
d
a
a
a
a
a
a
a
a
a
a
w
w
w
w
w
w
a
a
a
a
a
a
a
a
a
a
B
B
B
B
B
a
a
a
a
a
a
a
a
a
a
a
a
a
a
a
w
w
w
w
w
w
a
a
a
a
a
a
a
a
a
a
a
a
a
a
a
a
a
a
a
a
a
a
a
a
a
a
a
a
a
a
a
a
"}
(85,1,1) = {"
a
a
a
a
a
a
a
a
d
L
L
L
L
L
L
d
a
a
a
a
a
a
a
a
a
a
w
w
w
w
w
w
a
a
a
a
a
a
a
a
a
a
B
B
B
B
B
a
a
a
a
a
a
a
a
a
a
a
a
a
a
a
w
w
w
w
w
w
a
a
a
a
a
a
a
a
a
a
a
a
a
a
a
a
a
a
a
a
a
a
a
a
a
a
a
a
a
a
a
a
"}
(86,1,1) = {"
a
a
a
a
a
a
a
a
d
L
L
L
L
L
L
d
a
a
a
a
a
a
a
a
a
a
a
a
w
w
w
w
w
w
a
a
a
a
a
a
a
a
B
B
B
B
B
a
a
a
a
a
a
a
a
a
a
a
a
w
w
w
w
w
w
w
a
a
a
a
a
a
a
a
a
a
a
a
a
a
a
a
a
a
a
a
a
a
a
a
a
a
a
a
a
a
a
a
a
a
"}
(87,1,1) = {"
a
a
a
a
a
a
a
a
d
L
L
L
L
L
L
d
a
a
a
a
a
a
a
a
a
a
a
a
w
w
w
w
w
w
w
w
w
w
w
w
w
w
w
w
w
w
w
w
w
w
w
w
w
w
w
w
w
w
w
w
w
w
w
w
w
w
a
a
a
a
a
a
a
a
a
a
a
a
a
a
a
a
a
a
a
a
a
a
a
a
a
a
a
a
a
a
a
a
a
a
"}
(88,1,1) = {"
a
a
a
a
a
a
a
a
d
L
L
L
L
L
L
d
a
a
a
a
a
a
a
a
a
a
a
a
w
w
w
w
w
w
w
w
w
w
w
w
w
w
w
w
w
w
w
w
w
w
w
w
w
w
w
w
w
w
w
w
w
w
w
w
w
w
a
a
a
a
a
a
a
a
a
a
a
a
a
a
a
a
a
a
a
a
a
a
a
a
a
a
a
a
a
a
a
a
a
a
"}
(89,1,1) = {"
a
a
a
a
a
a
a
a
d
L
L
L
L
L
L
d
a
a
a
a
a
a
a
a
a
a
a
a
w
w
w
w
w
w
w
w
w
w
w
w
w
w
w
w
w
w
w
w
w
w
w
w
w
w
w
w
w
w
w
w
w
w
w
w
w
w
a
a
a
a
a
a
a
a
a
a
a
a
a
a
a
a
a
a
a
a
a
a
a
a
a
a
a
a
a
a
a
a
a
a
"}
(90,1,1) = {"
a
a
a
a
a
a
a
a
d
L
L
L
L
L
L
d
a
a
a
a
a
a
a
n
a
a
a
a
a
a
a
w
w
w
w
w
w
w
w
w
w
w
w
w
w
w
w
w
w
w
w
w
w
w
w
w
w
w
w
w
w
w
a
a
a
a
a
a
a
a
a
a
a
a
a
a
a
a
a
a
a
a
a
a
a
a
a
a
a
a
a
a
a
a
a
a
a
a
a
a
"}
(91,1,1) = {"
a
a
a
a
a
a
a
a
d
L
L
L
L
L
L
d
a
a
a
a
a
a
n
n
n
a
a
a
a
a
a
a
a
w
w
w
w
w
w
w
w
w
w
w
w
w
w
w
w
w
w
w
w
w
w
w
w
w
w
w
a
a
a
a
a
a
a
a
a
a
a
a
a
a
a
a
a
a
a
a
a
a
a
a
a
a
a
a
a
a
a
a
a
a
a
a
a
a
a
a
"}
(92,1,1) = {"
a
a
a
a
a
a
a
a
d
L
L
L
L
L
L
d
a
a
a
a
n
n
n
n
n
n
n
a
n
a
a
a
a
a
a
a
a
a
a
a
a
a
a
a
a
a
a
a
a
a
a
a
a
a
a
a
a
a
a
a
a
a
a
a
a
a
a
a
a
a
a
a
a
a
a
a
a
a
a
a
a
a
a
a
a
a
a
a
a
a
a
a
a
a
a
a
a
a
a
a
"}
(93,1,1) = {"
a
a
a
a
a
a
a
a
d
L
L
L
L
L
L
d
a
n
n
n
n
n
n
n
n
n
n
n
n
n
a
a
a
a
a
a
a
a
a
a
a
a
a
a
a
a
a
a
a
a
a
a
a
a
a
a
a
a
a
a
a
a
a
a
a
a
a
a
a
a
a
a
a
a
a
a
a
a
a
a
a
a
a
a
a
a
a
a
a
a
a
a
a
a
a
a
a
a
a
a
"}
(94,1,1) = {"
a
a
a
a
a
a
a
a
d
L
L
L
L
L
L
d
n
n
n
n
n
n
n
n
n
n
n
n
n
n
n
a
a
a
a
a
a
a
a
a
a
a
a
a
a
a
a
a
a
a
a
a
a
a
a
a
a
a
a
a
a
a
a
a
a
a
a
a
a
a
a
a
a
a
a
a
a
a
a
a
a
a
a
a
a
a
a
a
a
a
a
a
a
a
a
a
a
a
a
a
"}
(95,1,1) = {"
a
a
a
a
a
a
a
a
d
L
L
L
L
L
L
d
n
n
E
E
E
E
E
n
n
n
n
n
n
n
n
a
a
a
a
a
a
a
a
a
a
a
a
V
V
V
V
a
a
a
a
a
a
a
a
a
a
a
a
a
a
a
a
a
a
a
a
a
a
a
a
a
a
a
a
a
a
a
a
a
a
a
a
a
a
a
a
a
a
a
a
a
a
a
a
a
a
a
a
a
"}
(96,1,1) = {"
a
a
a
a
a
d
d
d
d
L
L
L
L
L
L
d
n
E
E
n
n
n
E
n
n
n
n
n
n
n
n
n
a
a
n
n
a
a
a
a
a
a
a
V
V
V
V
a
a
a
a
a
a
a
a
a
a
a
a
a
a
a
a
a
a
a
a
a
a
a
a
a
a
a
a
a
a
a
a
a
a
a
a
a
a
a
a
a
a
a
a
a
a
a
a
a
a
a
a
a
"}
(97,1,1) = {"
a
a
a
a
a
d
a
a
d
L
L
L
L
L
L
d
n
E
n
n
n
n
E
E
E
E
n
n
n
n
n
n
a
a
n
n
a
a
a
a
a
a
a
V
V
V
V
a
a
a
a
a
a
a
a
a
a
a
a
a
a
a
a
a
a
a
a
a
a
a
a
a
a
a
a
a
a
a
a
a
a
a
a
a
a
a
a
a
a
a
a
a
a
a
a
a
a
a
a
a
"}
(98,1,1) = {"
a
a
a
a
a
d
a
a
d
L
L
L
L
L
L
d
n
E
n
n
n
n
n
n
n
E
n
n
n
n
n
n
a
a
n
a
a
a
a
a
a
a
V
V
V
V
V
V
a
a
a
a
a
a
a
a
a
a
a
a
a
a
a
a
a
a
a
a
a
a
a
a
a
a
a
a
a
a
a
a
a
a
a
a
a
a
a
a
a
a
a
a
a
a
a
a
a
a
a
a
"}
(99,1,1) = {"
a
a
a
a
a
d
a
a
d
L
L
L
L
L
L
d
n
E
n
n
n
n
n
n
n
E
n
n
n
n
n
n
a
a
n
a
a
a
a
a
a
a
V
V
V
V
V
V
a
a
a
a
a
a
a
a
a
a
a
a
a
a
a
a
a
a
a
a
a
a
a
a
a
a
a
a
a
a
a
a
a
a
a
a
a
a
a
a
a
a
a
a
a
a
a
a
a
a
a
a
"}
(100,1,1) = {"
a
a
a
a
a
d
a
a
d
L
L
L
L
L
L
d
n
E
n
n
n
n
n
n
n
E
n
n
n
n
n
n
a
a
n
a
a
a
a
a
a
V
V
V
V
V
V
V
V
a
a
a
a
a
a
a
a
a
a
a
a
a
a
a
a
a
a
a
a
a
a
a
a
a
a
a
a
a
a
a
a
a
a
a
a
a
a
a
a
a
a
a
a
a
a
a
a
a
a
a
"}
(101,1,1) = {"
a
a
a
a
a
d
a
a
d
L
L
L
L
L
L
d
n
E
n
n
n
n
E
E
E
E
n
n
n
n
n
n
a
a
a
a
a
a
a
a
a
V
V
V
V
V
V
V
V
a
a
a
a
a
a
a
a
a
a
a
a
a
a
a
a
a
a
a
a
a
a
a
a
a
a
a
a
a
a
a
a
a
a
a
a
a
a
a
a
a
a
a
a
a
a
a
a
a
a
a
"}
(102,1,1) = {"
a
a
a
a
a
d
a
a
d
L
L
L
L
L
L
d
n
E
E
n
n
n
E
n
n
n
n
n
n
n
n
n
a
a
a
a
a
V
V
V
V
V
V
V
V
V
V
V
V
V
V
V
V
a
a
a
a
a
a
a
a
a
a
a
a
a
a
a
a
a
a
a
a
a
a
a
a
a
a
a
a
a
a
a
a
a
a
a
a
a
a
a
a
a
a
a
a
a
a
a
"}
(103,1,1) = {"
a
a
a
a
a
d
d
d
d
L
L
L
L
L
L
d
n
n
E
E
E
E
E
n
n
n
n
n
n
n
n
n
a
a
a
V
V
V
V
V
V
V
V
V
V
V
V
V
V
V
V
V
V
V
V
a
a
a
a
a
a
a
a
a
a
a
a
a
a
a
a
a
a
a
a
a
a
a
a
a
a
a
a
a
a
a
a
a
a
a
a
a
a
a
a
a
a
a
a
a
"}
(104,1,1) = {"
a
a
a
a
a
a
a
a
d
L
L
L
L
L
L
d
n
n
n
n
n
n
n
n
n
n
n
n
n
n
n
n
a
a
r
V
V
V
V
V
V
V
V
a
a
a
a
V
V
V
V
V
V
V
r
a
a
a
a
a
a
a
a
a
a
a
a
a
a
a
a
a
a
a
a
a
a
a
a
a
a
a
a
a
a
a
a
a
a
a
a
a
a
a
a
a
a
a
a
a
"}
(105,1,1) = {"
a
a
a
a
a
a
a
a
d
L
L
L
L
L
L
n
n
n
n
n
n
n
n
n
n
n
n
n
n
n
n
n
a
a
V
V
V
V
V
V
V
V
a
a
a
a
a
a
V
V
V
V
V
V
V
a
a
a
a
a
a
a
a
a
a
a
a
a
a
a
a
a
a
a
a
a
a
a
a
a
a
a
a
a
a
a
a
a
a
a
a
a
a
a
a
a
a
a
a
a
"}
(106,1,1) = {"
a
a
a
a
a
a
a
a
d
L
L
L
L
L
L
n
n
n
n
n
n
n
n
n
n
n
n
n
n
n
n
n
a
a
V
V
V
V
V
V
V
V
a
a
a
a
a
a
V
V
V
V
V
V
V
a
a
a
a
a
a
a
a
a
a
a
a
a
a
a
a
a
a
a
a
a
a
a
a
a
a
a
a
a
a
a
a
a
a
a
a
a
a
a
a
a
a
a
a
a
"}
(107,1,1) = {"
a
a
a
a
a
a
a
a
d
L
L
L
L
L
L
n
n
n
n
n
n
n
n
n
n
n
n
n
n
n
n
n
a
a
V
V
V
V
V
V
V
V
V
a
a
a
a
V
V
V
V
V
V
V
V
a
a
a
a
a
a
a
a
a
a
a
a
a
a
a
a
a
a
a
a
a
a
a
a
a
a
a
a
a
a
a
a
a
a
a
a
a
a
a
a
a
a
a
a
a
"}
(108,1,1) = {"
a
a
a
a
a
a
a
a
d
L
L
L
L
L
L
n
n
n
n
n
n
n
n
n
n
n
n
n
n
n
n
n
a
a
a
V
V
V
V
V
V
V
V
V
V
V
V
V
V
V
V
V
V
V
V
a
a
a
a
a
a
a
a
a
a
a
a
a
a
a
a
a
a
a
a
a
a
a
a
a
a
a
a
a
a
a
a
a
a
a
a
a
a
a
a
a
a
a
a
a
"}
(109,1,1) = {"
a
a
a
a
a
a
a
a
d
L
L
L
L
L
L
n
n
n
n
n
n
n
n
n
n
n
n
n
n
n
n
n
a
a
n
n
a
V
V
V
V
V
V
V
V
V
V
V
V
V
V
V
V
a
a
a
a
a
a
a
a
a
a
a
a
a
a
a
a
a
a
a
a
a
a
a
a
a
a
a
a
a
a
a
a
a
a
a
a
a
a
a
a
a
a
a
a
a
a
a
"}
(110,1,1) = {"
a
a
a
a
a
a
a
a
d
L
L
L
L
L
L
n
n
n
n
n
n
n
n
n
n
n
n
n
n
n
n
n
a
a
n
n
a
a
a
a
a
V
V
V
V
V
V
V
V
a
a
a
a
a
a
a
a
a
a
a
a
a
a
a
a
a
a
a
a
a
a
a
a
a
a
a
a
a
a
a
a
a
a
a
a
a
a
a
a
a
a
a
a
a
a
a
a
a
a
a
"}
(111,1,1) = {"
a
a
a
a
a
a
a
a
d
L
L
L
L
L
L
n
n
n
n
n
n
n
n
n
n
E
E
E
E
E
E
n
a
a
n
n
a
a
a
a
a
V
V
V
V
V
V
V
V
a
a
a
a
a
a
a
a
a
a
a
a
a
a
a
a
a
a
a
a
a
a
a
a
a
a
a
a
a
a
a
a
a
a
a
a
a
a
a
a
a
a
a
a
a
a
a
a
a
a
a
"}
(112,1,1) = {"
a
a
a
a
a
a
a
a
d
L
L
L
L
L
L
n
n
n
n
n
n
n
n
n
n
E
n
n
n
n
E
n
a
a
n
n
n
a
a
a
a
a
V
V
V
V
V
V
a
a
a
a
a
a
a
a
a
a
a
a
a
a
a
a
a
a
a
a
a
a
a
a
a
a
a
a
a
a
a
a
a
a
a
a
a
a
a
a
a
a
a
a
a
a
a
a
a
a
a
a
"}
(113,1,1) = {"
a
a
a
a
a
a
a
a
d
L
L
L
L
L
L
d
n
E
E
E
E
E
E
n
n
E
n
n
n
n
E
n
a
a
n
n
n
a
a
a
a
a
V
V
V
V
V
V
a
a
a
a
a
a
a
a
a
a
a
a
a
a
a
a
a
a
a
a
a
a
a
a
a
a
a
a
a
a
a
a
a
a
a
a
a
a
a
a
a
a
a
a
a
a
a
a
a
a
a
a
"}
(114,1,1) = {"
a
a
a
a
a
a
a
a
d
L
L
L
L
L
L
d
n
E
n
n
n
n
E
n
n
E
n
n
n
n
E
n
a
a
n
n
n
a
a
a
a
a
a
V
V
V
V
a
a
a
a
a
a
a
a
a
a
a
a
a
a
a
a
a
a
a
a
a
a
a
a
a
a
a
a
a
a
a
a
a
a
a
a
a
a
a
a
a
a
a
a
a
a
a
a
a
a
a
a
a
"}
(115,1,1) = {"
a
a
a
a
a
a
a
a
d
L
L
L
L
L
L
d
n
E
n
n
n
n
E
E
E
E
n
n
n
n
E
n
a
a
n
n
n
a
a
a
a
a
a
V
V
V
V
a
a
a
a
a
a
a
a
a
a
a
a
a
a
a
a
a
a
a
a
a
a
a
a
a
a
a
a
a
a
a
a
a
a
a
a
a
a
a
a
a
a
a
a
a
a
a
a
a
a
a
a
a
"}
(116,1,1) = {"
a
a
a
a
a
a
a
a
d
L
L
L
L
L
L
d
n
E
n
n
n
n
n
n
n
n
n
n
n
n
E
n
a
a
n
n
n
a
a
a
a
a
a
a
a
a
a
a
a
a
a
a
a
a
a
a
a
a
a
a
a
a
a
a
a
a
a
a
a
a
a
a
a
a
a
a
a
a
a
a
a
a
a
a
a
a
a
a
a
a
a
a
a
a
a
a
a
a
a
a
"}
(117,1,1) = {"
a
a
a
a
a
a
a
a
d
L
L
L
L
L
L
d
n
E
n
n
n
n
n
n
n
n
n
n
n
n
E
n
n
n
n
n
a
a
a
a
a
a
a
a
a
a
a
a
a
a
a
a
a
a
a
a
a
a
a
a
a
a
a
a
a
a
a
a
a
a
a
a
a
a
a
a
a
a
a
a
a
a
a
a
a
a
a
a
a
a
a
a
a
a
a
a
a
a
a
a
"}
(118,1,1) = {"
a
a
a
a
a
a
a
a
d
I
I
I
I
I
I
d
n
E
n
n
n
n
E
E
E
E
n
n
n
n
E
n
n
n
n
n
a
a
a
a
a
a
a
a
a
a
a
a
a
a
a
a
a
a
a
a
a
a
a
a
a
a
a
a
a
a
a
a
a
a
a
a
a
a
a
a
a
a
a
a
a
a
a
a
a
a
a
a
a
a
a
a
a
a
a
a
a
a
a
a
"}
(119,1,1) = {"
a
a
a
a
a
a
a
a
d
L
L
L
L
L
L
d
n
E
E
E
E
E
E
n
n
E
E
E
E
E
E
n
n
n
n
n
n
a
a
a
a
a
a
a
a
a
a
a
a
a
a
a
a
a
a
a
a
a
a
a
a
a
a
a
a
a
a
a
a
a
a
a
a
a
a
a
a
a
a
a
a
a
a
a
a
a
a
a
a
a
a
a
a
a
a
a
a
a
a
a
"}
(120,1,1) = {"
a
a
a
a
a
a
a
a
d
L
L
L
L
L
L
d
n
n
n
n
n
n
n
n
n
n
n
n
n
n
n
n
n
n
n
n
a
a
a
a
a
a
a
a
a
a
a
a
a
a
a
a
a
a
a
a
a
a
a
a
a
a
a
a
a
a
a
a
a
a
a
a
a
a
a
a
a
a
a
a
a
a
a
a
a
a
a
a
a
a
a
a
a
a
a
a
a
a
a
a
"}
(121,1,1) = {"
a
a
a
a
a
a
a
a
d
L
L
L
L
L
L
d
n
n
n
n
n
n
n
n
n
n
n
n
n
n
n
n
n
n
n
n
a
a
a
a
a
a
a
a
a
a
a
a
a
a
a
a
a
a
a
a
a
a
a
a
a
a
a
a
a
a
a
a
a
a
a
a
a
a
a
a
a
a
a
a
a
a
a
a
a
a
a
a
a
a
a
a
a
a
a
a
a
a
a
a
"}
(122,1,1) = {"
a
a
a
a
a
a
a
a
d
L
L
L
L
L
L
d
n
n
n
n
n
n
n
n
n
a
a
a
n
n
a
a
a
a
a
a
a
a
a
a
a
a
a
a
a
a
a
a
a
a
a
a
a
a
a
a
a
a
a
a
a
a
a
a
a
a
a
a
a
a
a
a
a
a
a
a
a
a
a
a
a
a
a
a
a
a
a
a
a
a
a
a
a
a
a
a
a
a
a
a
"}
(123,1,1) = {"
a
a
a
a
a
a
a
a
d
L
L
L
L
L
L
d
n
n
n
n
n
n
n
n
a
a
a
a
a
n
a
a
a
a
a
a
a
a
a
a
a
a
a
a
a
a
a
a
a
a
a
a
a
a
a
a
a
a
a
a
a
a
a
a
a
a
a
a
a
a
a
a
a
a
a
a
a
a
a
a
a
a
a
a
a
a
a
a
a
a
a
a
a
a
a
a
a
a
a
a
"}
(124,1,1) = {"
a
a
a
a
a
a
a
a
d
I
I
I
I
I
I
d
a
n
n
n
n
n
n
a
a
a
a
a
a
a
a
a
a
a
a
a
a
a
a
a
a
a
a
a
a
a
a
a
a
a
a
a
a
a
a
a
a
a
a
a
a
a
a
a
a
a
a
a
a
a
a
a
a
a
a
a
a
a
a
a
a
a
a
a
a
a
a
a
a
a
a
a
a
a
a
a
a
a
a
a
"}
(125,1,1) = {"
a
a
a
a
a
a
a
a
d
d
d
d
d
d
d
d
a
a
a
a
a
a
a
a
a
a
a
a
a
a
a
a
a
a
a
a
a
a
a
a
a
a
a
a
a
a
a
a
a
a
a
a
a
a
a
a
a
a
a
a
a
a
a
a
a
a
a
a
a
a
a
a
a
a
a
a
a
a
a
a
a
a
a
a
a
a
a
a
a
a
a
a
a
a
a
a
a
a
a
a
"}
